///#####/////////////////
//## @ #/////////////////
//#    #//#####////######
/##   #####   ######    #
##   ##  .#   #   #  ## #
# . ## $#.##  $  ## ##  #
#   ##  $  # .#  #     ##
#   ###    ##   ## $$#. #
#  $  #  ####   ####  . #
# .$  ## #//## ##//## ###
### #### #///# #////# #//
//# #//# #///# #////# #//
### #### ##### ###### ###
#                       #
#########################