////////
########
#    **#
#@  $**#
#   $..#
########